{
    "configs": [
        {
            "id": 1,
            "colors": 3,
            "stage": [
                "2,2,2,2,2,2,2,2,2,2",
                "2,2,2,2,2,2,2,2,2,2",
                "2,2,2,2,2,2,2,2,2,2",
                "1,1,1,1,1,1,1,1,1,1",
                "1,1,1,1,1,1,1,1,1,1",
                "1,1,1,1,1,1,1,1,1,1",
                "1,1,1,1,1,1,1,1,1,1",
                "3,3,3,3,3,3,3,3,3,3",
                "3,3,3,3,3,3,3,3,3,3",
                "3,3,3,3,3,3,3,3,3,3"
            ]
        },
        {
            "id": 2,
            "colors": 3,
            "stage": [
                "1,2,3,1,2,3,1,2,3,1",
                "1,2,3,1,2,3,1,2,3,1",
                "1,2,3,1,2,3,1,2,3,1",
                "1,2,3,1,2,3,1,2,3,1",
                "1,2,3,1,2,3,1,2,3,1",
                "1,2,3,1,2,3,1,2,3,1",
                "1,2,3,1,2,3,1,2,3,1",
                "1,2,3,1,2,3,1,2,3,1",
                "1,2,3,1,2,3,1,2,3,1",
                "1,2,3,1,2,3,1,2,3,1"
            ]
        },
        {
            "id": 3,
            "colors": 2,
            "stage": [
                "2,2,1,2,2,2,2,2,2,2",
                "2,1,2,1,1,1,1,1,2,2",
                "2,2,2,2,2,1,1,2,2,2",
                "2,2,2,1,1,2,1,1,1,1",
                "2,1,2,1,1,1,2,2,1,1",
                "2,1,1,2,2,2,2,2,1,1",
                "2,1,1,1,1,1,1,1,1,1",
                "2,2,2,2,2,1,1,1,2,2",
                "2,1,2,2,2,2,1,2,2,2",
                "1,2,1,1,2,1,2,1,1,1"
            ]
        },
        {
            "id": 4,
            "colors": 2,
            "stage": [
                "2,1,1,2,2,2,2,2,2,2",
                "2,1,2,1,1,2,1,1,2,2",
                "2,2,2,1,2,1,1,2,2,2",
                "2,2,2,1,1,2,1,1,2,1",
                "2,1,2,1,1,1,2,2,1,1",
                "2,1,2,1,1,2,2,2,1,1",
                "2,1,2,2,1,2,2,1,2,1",
                "2,1,2,2,2,1,1,1,2,2",
                "2,1,2,2,2,1,1,2,2,1",
                "1,2,1,1,2,1,2,1,2,1"
            ]
        },
        {
            "id": 5,
            "colors": 2,
            "stage": [
                "2,1,1,2,1,1,2,1,1,1",
                "2,1,2,2,1,2,1,2,2,2",
                "2,2,2,2,2,1,1,2,2,2",
                "2,2,2,2,1,2,1,1,2,1",
                "2,1,2,2,1,1,2,1,1,1",
                "2,1,2,1,1,2,2,1,1,1",
                "2,1,1,1,1,2,2,1,2,1",
                "2,1,2,2,2,1,1,1,2,2",
                "2,1,2,2,2,1,1,2,2,1",
                "1,1,1,1,2,1,2,2,2,2"
            ]
        },
        {
            "id": 6,
            "colors": 2,
            "stage": [
                "2,1,1,2,2,1,1,1,2,1",
                "2,1,2,1,1,2,2,1,2,2",
                "2,2,2,1,2,1,2,2,2,2",
                "2,2,2,1,1,2,1,1,2,1",
                "2,1,2,1,1,1,2,1,1,1",
                "2,1,2,1,1,2,2,1,1,1",
                "1,2,2,2,1,2,2,1,2,1",
                "1,1,1,2,2,1,1,1,2,2",
                "1,1,1,2,2,1,1,1,2,1",
                "1,2,1,1,2,1,2,1,2,1"
            ]
        },
        {
            "id": 7,
            "colors": 2,
            "stage": [
                "2,1,1,2,2,2,2,2,1,2",
                "2,1,2,1,1,2,1,1,2,2",
                "2,2,1,1,2,1,1,1,1,2",
                "2,2,2,1,1,2,1,1,2,1",
                "2,1,2,1,2,1,2,2,1,1",
                "2,1,2,2,1,2,2,2,1,1",
                "2,1,2,2,1,2,2,1,2,1",
                "2,1,2,2,2,1,1,1,1,2",
                "2,1,2,2,2,1,1,1,1,1",
                "1,1,1,1,2,2,2,1,2,1"
            ]
        },
        {
            "id": 8,
            "colors": 2,
            "stage": [
                "2,1,1,2,2,2,2,2,2,2",
                "2,1,2,1,1,2,1,1,2,2",
                "2,2,2,2,2,1,1,2,2,2",
                "2,2,2,2,1,2,1,1,2,1",
                "2,1,2,1,1,1,2,2,1,1",
                "2,1,1,1,1,1,2,2,1,1",
                "2,1,2,2,1,2,2,1,2,1",
                "1,1,2,2,2,1,1,1,1,2",
                "2,1,2,1,2,1,1,2,1,1",
                "1,2,1,2,2,1,2,1,2,1"
            ]
        },
        {
            "id": 9,
            "colors": 2,
            "stage": [
                "1,1,1,2,2,1,1,1,1,1",
                "2,1,2,1,2,2,1,1,2,1",
                "2,2,2,1,2,1,1,2,2,2",
                "2,2,2,1,1,2,1,1,2,1",
                "2,1,2,1,1,1,1,2,1,2",
                "2,1,2,1,1,2,2,2,1,2",
                "2,1,2,1,1,2,2,1,2,1",
                "2,1,2,1,2,1,2,1,2,2",
                "2,1,2,2,2,1,2,2,2,1",
                "1,2,1,1,2,1,2,1,2,1"
            ]
        },
        {
            "id": 10,
            "colors": 2,
            "stage": [
                "2,1,1,2,2,2,2,2,2,2",
                "2,1,2,1,1,2,2,1,2,2",
                "1,2,2,1,2,1,1,2,2,2",
                "1,2,2,1,1,2,1,1,2,1",
                "1,1,2,1,2,2,2,2,1,1",
                "1,1,2,1,1,2,2,2,1,1",
                "2,1,2,2,1,1,1,1,2,1",
                "1,1,2,1,2,1,1,1,2,2",
                "2,1,2,1,2,1,1,2,2,1",
                "2,2,1,1,2,1,1,1,2,1"
            ]
        }
    ]
    
    
}